__T___T___
____T_____
__________
_T_____T__
____T_____
__X____T__
__________
__________