__T___T___
____T___T_
_XXX_T____
_T____X___
____T__X__
__X____T__
____T_____
__T___T___